
일상생활 = công việc hàng ngày
동사=động từ
가다=đi
오다=đến
자다=ngủ
먹다=ăn
마시다=uống
이야기하다=trò chuyện
읽다= đọc
듣다=nghe
보다=nhìn, xem
일하다=làm việc
공부하다=học
운동하다=tập luyện thể thao
쉬다=nghỉ ngơi
만나다=gặp
줗아하다=thích
형용사=tính từ
큽다=to, lớn
작다=nhỏ
많다=nhiều
적다=ít
좋다=tốt
나쁘다=ác, xấu
재미있다=thú vị
재미없다=buồn chán, vô vị
차= trà
커피= coffe
빵= bánh mì
영화=phim
음악= âm nhạc
신문= báo
친구= bạn
의문대명사 = đại từ nghi vấn 
무엇 = cái gì ?
어디 = ở đâu ?
누구 = ai đó ?
언제 = hồi nào, lúc nào
공원 = công viên
노래 = bài hát, ca khúc
대한빌딩 = tòa nhà daehan 
방 = phòng
산책하다= đi dạo, tản bộ
쇼핑하다 = mua sắm
시내 = nội thành 
시장 = thị truờng, chợ
식사하다 = ăn cơm
아이스크림 = kem
아주 = rất
여행 = du lịch 
이메일=thư điện tử
위=trên
자주=thừong xuyên
전화하다= gọi điện thoại
지금=hiện tại
죽구를 하다 = đá bóng
헬스클럽 = clb thể hình



