위로 올라 가세요 = hãy đi lên trên
아래로 내려가세요 = hãy đi xuống duới
안으로 들어오세요 = hãy đi vào trong
난 밖에 나가고 싶지 않아요 = tôi không muốn đi ra ngòai
그 건물은 도서관 옆에 있습니다 = tòa nhà ấy ở cạnh thư viện
은행하고 우체국 사이에 우리 집이 있어요 = nhà tôi ở giữa ngân hàng và bưu điện
그는 여자들 앞에서 부끄러워 한다 = cậu ấy xấu hổ truớc những cô gái
뒤에 타세요 = ngồi phía sau đi
왼쪽은 바다입니다 = bên phải là biển
오른쪽 서랍을 열어 보새요 = hãy mở ngăn kéo bên trái 
길 건너기 전에 양쪽을 잘 살펴라 = truớc khi băng qua đuờng hãy để ý 2 bên
길 건너편에서 버스를 타세요 = hãy lên xe buýt bên kia đuờng
똑바로 집으로 가세요 = hãy đi thẳng về nhà nhé
동으로 가요 = đi về huớng đông
바람이 서쪽에서 불어요 = gió thổi từ huớng tây
남으로 가다 = đi về huớng nam
서울 북쪽에 있어요 = seoul ở huớng bắc 
그는 개인 주택을 갖고 있습니까 = nó có nhà riêng không
그는 아파트에 살고 있어요 = nó sống ở chung cư
안방에는 아기가 잠들어 있었다 = đứa bé đang ngủ ở trong phòng
어머니는 공부방에서 아이들을 가르치고 계신다 = mẹ tôi dạy học cho những đứa trẻ tại phòng học
거실 청소를 하고 싶어요 = tôi muốn dọn phòng khác
먹기를 원하멱 부엌에 들어가야 한다 = muốn ăn thì lăn vào bếp
자동차를 현관에 대다 = xe đậu truớc cửa
비가 베란다에 똑똑 애린다 = mưa rơi tí tách trên hiên 
그는 오피스텔에 살고 있다 = họ sống tại nhà văn phòng 
세탁실을 깨끗하게 청소합시다 = hãy dọn phòng giặt đồ sạch sẽ
침실은 위층에 있습니다 =phòng ngủ ở trên tầng 
6시에 침대를 떠났어요 = rời khỏi giuờng lúc 6 giờ
그 책은 책상 위에있어요 = quyển sách ấy ở trên bàn
우린 새 옷장이 필오해요 = chúng ta cần tủ quần áo mới
오늘은 소파에서 자야 할 것 같아 = hôm nay chắc phải ngủ trên sô pha rồi
이 탁자는 주인이 없습니까 = cái bàn này có người ngồi chưa ?
식탁을 닦아 주세요 = hãy lau cái bàn này 
화장대 = bàn trang điểm
구두를 신발장에 놓아요 = hãy đặt giày vào tủ 
경찰서가 어디예요 = sở cảnh sát ở đâu 
이 근처에 세탁소 있어요 = ở gần đây có tiệm giặt là nào không 
박물관 입장료가 얼마죠 = phí vào công của viện bảo tàng là bao nhiêu
토요일마다 슈퍼마켓에 간다 = tôi đi siêu thị vào mỗi thứ 7
지하철 역이 없잖아 = không có ga tàu điện ngầm mà
은행 바로 건너평에 버스 정류장이 있습니다 = có trạm xe buýt ở đối diện ngân hàng
우리는 너무 배가 고파서 빵집으로 들어갔어요 = chúng tôi đói quá nên đi đến tiệm bánh mỳ
꽃집에서 꽃을 샀습니다 = tôi mua hoa ở tiệm hoa
나는 오늘 아침에 머리를 하러 미용실에 갔습니다 = tôi đã đến thẩm mỹ viện để làm tóc
기속사에 머물 거예요 = tôi sẽ ở lại ký túc xá
단독 주택에 살아요 = sống ở nhà riêng
대도시는 항상 아침에 교통이 복잡합니다 = giao thông buổi sáng ở thành phố lớn luôn phức tạp
교통이 불편해요 = giao thông bất tiện
지금 사무실에 계세요 = bây giờ đang ở văn phòng
마음대로 사용하세요 = hãy dùng tùy ý
나는 인터넷으로 책을 주문했습니다 = tôi dùng internet để đặt sách
자취집 = nhà trọ
정원에 나무가 많습니다 = có nhiều cây trong vuờn
요즘 어떻게 지내요 = dạo này sống sao ? 
지하에서 일해요 = tôi làm việc duới lòng đất
그는 아주 친절애요 = nó rất thân thiện
교통이 편리애요 = giao thông thuật tiện
마음이 편해요 = tâm trạng thoải mái
하숙비 = tiền trọ
하숙집 = nhà trọ
호텔 = hotel
혼자 실아요 = sống 1 mình
